#######################################
#                                     #
#                                     #
#                                     #
#                                     #
#                P                    #
#                                     #
#                                     #
#                                     #
#                                        #
#                                      #
#                                      #
#######################################
