##########
#    T   #
#   P    #
#   D    #
#   E    #
#        #
#        #
##########
