##########
#P       #
#   K    #
#   T    #
#   E    #
#        #
#        #
##########